NO ./text1.xpm
SO ./text2.xpm
WE ./text3.xpm
EA ./text4.xpm
F 20,100,0
C 225,30,0


11111111111111111111111111111111111111111111111111111111111111111111111111111111111
11111111111111111111111111111111111111111111111111111111111111111111111111111111111
11111111111111111111111111111111111111111111111111111111111111111111111111111111111
11111111111111111111111111111111111111111111111111111111111111111111111111111111111
11111111111111111111111111111111111111111111111111111111111111111111111111111111111
11111111111111111111111111111111111111111111111111111111111111111111111111111111111
11111111111111111111111111111111111111111111111111111111111111111111111111111111111
11111111111011111111111111111111111111111111111111111111111111111111111111111111111
11111111111011111111111111111111111111111111111111111111111111111111111111111111111
11111111111011111111111111111111111111111111111111111111111111111111111111111111111
11111111111000011111111111111111111111111111111111111111111111111111111111111111111
11111111111111001111111111111111111111111111111111111111111111111111111111111111111
11111111111111101111111111111111111111111111111111111111111111111111111111111111111
11111111111111101111111111111111111111111111111111111111111111111111111111111111111
11111111111111101111111111111111111111111111111111111111111111111111111111111111111
11111000000000001111111111111111111111111111111111111111111111111111111111111111111
11110011111111100000111111111111111111111111111111111111111111111111111111111111111
11110100010000011110111111111111111111111111111111111111111111111111111111111111111
11110111010000000000111111111111111111111111111111111111111111111111111111111111111
111100000100N0011111111111111111111111111111111111111111111111111111111111111111111
11111111010000010001111111111111111111111111111111111111111111111111111111111111111
11111111010000011100000000111111111111111111111111111111111111111111111111111111111
11111111001111111001111000111111111111111111111111111111111111111111111111111111111
11111111100000000011000000111111111111111111111111111111111111111111111111111111111
11111111111111111111111111111111111111111111111111111111111111111111111111111111111