NO ./text1.xpm
SO ./text2.xpm
WE ./text3.xpm
EA ./text4.xpm
F 250,1000,0
C 225,30,0

111111111111111111111111111111111
100000000000000000000000000000001
100000000000000000000000000000001
100000000000000000000000000000001
1000000000000000N0000000000000001
100000000000000000000000000000001
100000000000000000000000000000001
111111111111111111111111111111111